Joppa
An Interactive Fiction by Alden Jones
Release 1 / Serial number 180926 / Inform 7 build 6M62 (I6/v6.33 lib 6/12N) SD

Outskirts
Finally you have reached Joppa. You can see the edge of town just to the north. Maybe if you talk with someone there, you can find information about Qud.

You can see Mehmet and three Watervines here.

>Go north
Joppa
You can see Ctesiphus, Zealot, Irudad, a Warden, Tam and a chest (closed) here.

>open chest
    *** As soon as your hands touch the chest, the Warden wordlessly thrusts his sword through your back. You die. ***

Would you like to RESTART, RESTORE a saved game, QUIT or UNDO the last command?

>restart
Joppa
An Interactive Fiction by Alden Jones
Release 1 / Serial number 180926 / Inform 7 build 6M62 (I6/v6.33 lib 6/12N) SD

Outskirts
You can see Mehmet and three Watervines here.

>go north
Joppa
You can see Ctesiphus, Zealot, Irudad, a Warden, Tam and a chest (closed) here.

>go north
    *** Outside of town you visibility is limited by the tall watervine and brimblestalk marshes. You find a dry piece of land to make camp so that you can whip up a meal and sate your hunger. As you sit in this moment of peace, you are set upon by a crocodile, and killed. ***

Would you like to RESTART, RESTORE a saved game, QUIT or UNDO the last command?

>restart
Joppa
An Interactive Fiction by Alden Jones
Release 1 / Serial number 180926 / Inform 7 build 6M62 (I6/v6.33 lib 6/12N) SD

Outskirts
You can see Mehmet and three Watervines here.

* * *

>go north
Joppa
You can see Ctesiphus, Zealot, Irudad, a Warden, Tam and a chest (closed) here.

>go west
Argyve's Home

>go east
Joppa
You can see Ctesiphus, Zealot, Irudad, a Warden, Tam and a chest (closed) here.

>talk to Ctesiphus
You can't see any such thing.

>look
Joppa
You can see Ctesiphus, Zealot, Irudad, a Warden, Tam and a chest (closed) here.

>talk to Ctesiphus
You can't see any such thing.

* * *

>Go north
Joppa
You can see Ctesiphus, Zealot, Irudad, a Warden, Tam and a chest (closed) here.

>talk to Ctesiphus
You can't see any such thing.

>talk to Ctesiphus
You can't see any such thing.

>look Ctesiphus
You see nothing special about Ctesiphus.

>talk to Irudad
you say "live and drink, friend", Irudad responds "live and drink"

>Talk to Irudad
you say "live and drink, friend", Irudad responds "live and drink"

* * *

Joppa
An Interactive Fiction by Alden Jones
Release 1 / Serial number 180926 / Inform 7 build 6M62 (I6/v6.33 lib 6/12N) SD

Outskirts
Finally you have reached Joppa. You can see the edge of town just to the north. Maybe if you talk with someone there, you can find information about Qud.

You can see Mehmet and three Watervines here.

>Talk to Mehmet
you say "live and drink, friend", Mehmet responds "live and drink"

>examine Mehmet
You see nothing special about Mehmet.

* * *

Joppa
An Interactive Fiction by Alden Jones
Release 1 / Serial number 180926 / Inform 7 build 6M62 (I6/v6.33 lib 6/12N) SD

Outskirts
Finally you have reached Joppa. You can see the edge of town just to the north. Maybe if you talk with someone there, you can find information about Qud.

You can see Mehmet and three Watervines here.

>Talk to mehmet
you say "live and drink, friend",

* * *

Joppa
An Interactive Fiction by Alden Jones
Release 1 / Serial number 180926 / Inform 7 build 6M62 (I6/v6.33 lib 6/12N) SD

Outskirts
Finally you have reached Joppa. You can see the edge of town just to the north. Maybe if you talk with someone there, you can find information about Qud.

You can see Mehmet and three Watervines here.

>Walk
You'll have to say which compass direction to go in.

>walk
You'll have to say which compass direction to go in.

>walk up
You can't go that way.

>walk down
You can't go that way.

>walk south
You can't go that way.

>walk north
You can't go that way.

* * *

Joppa
An Interactive Fiction by Alden Jones
Release 1 / Serial number 180926 / Inform 7 build 6M62 (I6/v6.33 lib 6/12N) SD

Outskirts
Finally you have reached Joppa. You can see the edge of town just to the north. Maybe if you talk with someone there, you can find information about Qud.

You can see Mehmet and three Watervines here.

>dance
You dance

>dancing
That's not a verb I recognise.

>dance
That's not a verb I recognise.

* * *

Joppa
An Interactive Fiction by Alden Jones
Release 1 / Serial number 180926 / Inform 7 build 6M62 (I6/v6.33 lib 6/12N) SD

Outskirts
Finally you have reached Joppa. You can see the edge of town just to the north. Maybe if you talk with someone there, you can find information about Qud.

You can see Mehmet and three Watervines here.

>examine Mehmet
Years in the desert have taken their toll on his body, yet he commands your ear with his voice like few other men, and you wonder what sovereignty he would have come to were he not born a moisture farmer.

* * *

Joppa
An Interactive Fiction by Alden Jones
Release 1 / Serial number 180926 / Inform 7 build 6M62 (I6/v6.33 lib 6/12N) SD

Outskirts
Finally you have reached Joppa. You can see the edge of town just to the north. Maybe if you talk with someone there, you can find information about Qud.

You can see Mehmet and three Watervines here.

>examine piano
You see nothing special about the grand piano.

>check piano
You see nothing special about the grand piano.

>tune piano
That's not a verb I recognise.

* * *

Joppa
An Interactive Fiction by Alden Jones
Release 1 / Serial number 180926 / Inform 7 build 6M62 (I6/v6.33 lib 6/12N) SD

Outskirts
Finally you have reached Joppa. You can see the edge of town just to the north. Maybe if you talk with someone there, you can find information about Qud.

You can see Mehmet and three Watervines here.

>go north
Joppa
Innumberable baubles and curiousities fill this workshop, shaded from the sunsear by a piece of sheet metal pitched on the roof.

You can see Ctesiphus, Irudad, a Warden, Tam and a chest (closed) here.

>go east
    *** Outside of town you visibility is limited by the tall watervine and brimblestalk marshes. You find a dry piece of land to make camp so that you can whip up a meal and sate your hunger. As you sit in this moment of peace, you are set upon by a crocodile, and killed. ***

Would you like to RESTART, RESTORE a saved game, QUIT or UNDO the last command?

>restart
Joppa
An Interactive Fiction by Alden Jones
Release 1 / Serial number 180926 / Inform 7 build 6M62 (I6/v6.33 lib 6/12N) SD

Outskirts
You can see Mehmet and three Watervines here.

* * *

>go north
Joppa
Innumberable baubles and curiousities fill this workshop, shaded from the sunsear by a piece of sheet metal pitched on the roof.

You can see Ctesiphus, Irudad, a Warden, Tam and a chest (closed) here.

>go outside
Street

* * *

>go north
Joppa
Innumberable baubles and curiousities fill this workshop, shaded from the sunsear by a piece of sheet metal pitched on the roof.

You can see Ctesiphus, Irudad, a Warden, Tam and a chest (closed) here.

>go south
Outskirts
You can see Mehmet here.

>go north
Joppa

>go east
You can't go that way.

* * *

>go north
Joppa
Innumberable baubles and curiousities fill this workshop, shaded from the sunsear by a piece of sheet metal pitched on the roof.

You can see Ctesiphus, Irudad, a Warden, Tam and a chest (closed) here.

>go west
Argyve's Home
You can see Argyve here.

>talk to Argyve
Argyve refuses to look up from his work bench to acknowledge your presence
you say "live and drink, friend", Argyve responds "live and drink"

* * *

>go north
Joppa
Innumberable baubles and curiousities fill this workshop, shaded from the sunsear by a piece of sheet metal pitched on the roof.

You can see Ctesiphus, Irudad, a Warden, Tam and a chest (closed) here.

>look ctesiphus
One star-ribboned night, a ray cat crossed the marshy loam and wandered into Joppa. The watervine farmers, wakened by the joyful cries of a small girl, gathered around to revel at the favorable omen and extol the generosity of the Beetle Moon. Since then, Ctesiphus has spent his days curled under the shade of brinestalk huts and sauntering over dirt paths. So long as he's approached with care, he welcomes the hands of friends and strangers alike.

>pet Ctesiphus
That's not a verb I recognise.

>touch Ctesiphus
You feel nothing unexpected.

>talk to Warden
you say "live and drink, friend", the Warden responds "..."

>open chest
    *** As soon as your hands touch the chest, the Warden wordlessly thrusts his sword through your back. You die. ***

Would you like to RESTART, RESTORE a saved game, QUIT or UNDO the last command?

* * *

>go north
Joppa
Innumberable baubles and curiousities fill this workshop, shaded from the sunsear by a piece of sheet metal pitched on the roof.

You can see Ctesiphus, Irudad, a Warden, Tam and a chest (closed) here.

>open chest
    *** As soon as your hands touch the chest, the Warden wordlessly thrusts his sword through your back. You die. ***

Would you like to RESTART, RESTORE a saved game, QUIT or UNDO the last command?

>close chest
You close the chest.

>open chest
    *** As soon as your hands touch the chest, the Warden wordlessly thrusts his sword through your back. You die. ***

Would you like to RESTART, RESTORE a saved game, QUIT or UNDO the last command?

>restart
Joppa
An Interactive Fiction by Alden Jones
Release 1 / Serial number 180926 / Inform 7 build 6M62 (I6/v6.33 lib 6/12N) SD

Outskirts
Finally you have reached Joppa. You can see the edge of town just to the north.

You can see Mehmet and three Watervines here.

>go north
Joppa
You can see Ctesiphus, Zealot, Irudad, a Warden, Tam and a chest (closed) here.

* * *

>go north
    *** Outside of town you visibility is limited by the tall watervine and brimblestalk marshes. You find a dry piece of land to make camp so that you can whip up a meal and sate your hunger. As you sit in this moment of peace, you are set upon by a crocodile, and killed. ***

Would you like to RESTART, RESTORE a saved game, QUIT or UNDO the last command?

>restart
Joppa
An Interactive Fiction by Alden Jones
Release 1 / Serial number 180926 / Inform 7 build 6M62 (I6/v6.33 lib 6/12N) SD

Outskirts
Finally you have reached Joppa. You can see the edge of town just to the north.

You can see Mehmet and three Watervines here.

* * *

>go north
Joppa
Innumberable baubles and curiousities fill this workshop, shaded from the sunsear by a piece of sheet metal pitched on the roof.

You can see Ctesiphus, Irudad, a Warden, Tam and a chest (closed) here.

>talk to Ctesiphus
You can't see any such thing.

>examine Ctesiphus
One star-ribboned night, a ray cat crossed the marshy loam and wandered into Joppa. The watervine farmers, wakened by the joyful cries of a small girl, gathered around to revel at the favorable omen and extol the generosity of the Beetle Moon. Since then, Ctesiphus has spent his days curled under the shade of brinestalk huts and sauntering over dirt paths. So long as he's approached with care, he welcomes the hands of friends and strangers alike.

* * *

>go north
Joppa
Innumberable baubles and curiousities fill this workshop, shaded from the sunsear by a piece of sheet metal pitched on the roof.

You can see Ctesiphus, Irudad, a Warden, Tam and a chest (closed) here.

>talk to Irudad
you say "live and drink, friend", Irudad responds "live and drink"

* * *

>go north
Joppa
Innumberable baubles and curiousities fill this workshop, shaded from the sunsear by a piece of sheet metal pitched on the roof.

You can see Ctesiphus, Irudad, a Warden, Tam and a chest (closed) here.

>talk to Tam
care to make a trade, Dromad?", Tam responds "I would, if I saw that you had anything of value"

* * *

Joppa
An Interactive Fiction by Alden Jones
Release 1 / Serial number 180926 / Inform 7 build 6M62 (I6/v6.33 lib 6/12N) SD

Outskirts
Finally you have reached Joppa. You can see the edge of town just to the north. Maybe if you talk with someone there, you can find information about Qud.

You can see Mehmet and three Watervines here.

>go south
    *** Outside of town you visibility is limited by the tall watervine and brimblestalk marshes. You find a dry piece of land to make camp so that you can whip up a meal and sate your hunger. As you sit in this moment of peace, you are set upon by a hulking baboon, and killed. ***

Would you like to RESTART, RESTORE a saved game, QUIT or UNDO the last command?

>go south
Please give one of the answers above.

Would you like to RESTART, RESTORE a saved game, QUIT or UNDO the last command?

>restart
Joppa
An Interactive Fiction by Alden Jones
Release 1 / Serial number 180926 / Inform 7 build 6M62 (I6/v6.33 lib 6/12N) SD

Outskirts
Finally you have reached Joppa. You can see the edge of town just to the north.

You can see Mehmet and three Watervines here.

>go south
    *** Outside of town you visibility is limited by the tall watervine and brimblestalk marshes. You find a dry piece of land to make camp so that you can whip up a meal and sate your hunger. As you sit in this moment of peace, you are set upon by a hulking baboon, and killed. ***

Would you like to RESTART, RESTORE a saved game, QUIT or UNDO the last command?

>restart
Joppa
An Interactive Fiction by Alden Jones
Release 1 / Serial number 180926 / Inform 7 build 6M62 (I6/v6.33 lib 6/12N) SD

Outskirts
Finally you have reached Joppa. You can see the edge of town just to the north.

You can see Mehmet and three Watervines here.

>examine Mehmet
Years in the desert have taken their toll on his body, yet he commands your ear with his voice like few other men, and you wonder what sovereignty he would have come to were he not born a moisture farmer.

>talk to Mehmet
you say "live and drink, friend", Mehmet responds "live and drink"

* * *

>go south
    *** Outside of town you visibility is limited by the tall watervine and brimblestalk marshes. You find a dry piece of land to make camp so that you can whip up a meal and sate your hunger. As you sit in this moment of peace, you are set upon by a hulking baboon, and killed. ***

Would you like to RESTART, RESTORE a saved game, QUIT or UNDO the last command?

>restart
Joppa
An Interactive Fiction by Alden Jones
Release 1 / Serial number 180926 / Inform 7 build 6M62 (I6/v6.33 lib 6/12N) SD

Joppa Outskirts
You can see Mehmet here.

>go north
Joppa Outskirts
You can see Mehmet here.

* * *

Joppa
An Interactive Fiction by Alden Jones
Release 1 / Serial number 180926 / Inform 7 build 6M62 (I6/v6.33 lib 6/12N) SD

Outskirts
Finally you have reached Joppa. You can see the edge of town just to the north. Maybe if you talk with someone there, you can find information about Qud.

You can see Mehmet and three Watervines here.

>look
Studio
You can see a grand piano and a key here.

>examine piano
You see nothing special about the grand piano.

>eat piano
That's plainly inedible.

>eat Studio
You can't see any such thing.

>eat everything
You can't use multiple objects with that verb.

* * *

>look
Studio
You can see a grand piano and a key here.

>go north
Bar
You can see a french horn and a bartender here.

>take bartender
Taken.

>go outside
Street
You can see a discarded newspaper here.

>read newspaper
You see nothing special about the discarded newspaper.

>drop bartender
Dropped.

>look
Street
You can see a bartender and a discarded newspaper here.

>talk bartender
That's not a verb I recognise.

>inventory
You are carrying nothing.

>eat newspaper
That's plainly inedible.

* * *

Joppa
An Interactive Fiction by Alden Jones
Release 1 / Serial number 180926 / Inform 7 build 6M62 (I6/v6.33 lib 6/12N) SD

Outskirts
Finally you have reached Joppa. You can see the edge of town just to the north. Maybe if you talk with someone there, you can find information about Qud.

You can see Mehmet and three Watervines here.

>ls
That's not a verb I recognise.

>Go north
Joppa

>go east
    *** Outside of town you visibility is limited by the tall watervine and brimblestalk marshes. You find a dry piece of land to make camp so that you can whip up a meal and sate your hunger. As you sit in this moment of peace, you are set upon by a crocodile, and killed. ***

Would you like to RESTART, RESTORE a saved game, QUIT or UNDO the last command?

* * *

Joppa
An Interactive Fiction by Alden Jones
Release 1 / Serial number 180926 / Inform 7 build 6M62 (I6/v6.33 lib 6/12N) SD

Outskirts
Finally you have reached Joppa. You can see the edge of town just to the north. Maybe if you talk with someone there, you can find information about Qud.

You can see Mehmet and three Watervines here.

>play piano
You play a tune on the grand piano. It sounds awful

>examine piano
You see nothing special about the grand piano.

* * *

>play piano
You play a tune on the grand piano. It sounds awful

>tune piano
you tune the grand piano

>take key
Taken.

>take piano
Taken.

>inventory
You are carrying:
  a grand piano
  a key

* * *

Joppa
An Interactive Fiction by Alden Jones
Release 1 / Serial number 180926 / Inform 7 build 6M62 (I6/v6.33 lib 6/12N) SD

Outskirts
Finally you have reached Joppa. You can see the edge of town just to the north. Maybe if you talk with someone there, you can find information about Qud.

You can see Mehmet and three Watervines here.

>take all
Watervine: Taken.
Watervine: Taken.
Watervine: Taken.

>eat watervine
That's plainly inedible.

* * *

Joppa
An Interactive Fiction by Alden Jones
Release 1 / Serial number 180926 / Inform 7 build 6M62 (I6/v6.33 lib 6/12N) SD

Outskirts
Finally you have reached Joppa. You can see the edge of town just to the north. Maybe if you talk with someone there, you can find information about Qud.

You can see Mehmet and three Watervines here.

>take watervines
Taken.

>eat watervine
You eat the Watervine. Not bad.

>inventory
You are carrying nothing.

>eat watervine
(first taking the Watervine)
You eat the Watervine. Not bad.

>take watervine
Taken.

>ls
That's not a verb I recognise.

>inventory
You are carrying:
  a Watervine

>eat watervine
You eat the Watervine. Not bad.

* * *

Joppa
An Interactive Fiction by Alden Jones
Release 1 / Serial number 180926 / Inform 7 build 6M62 (I6/v6.33 lib 6/12N) SD

Outskirts
Finally you have reached Joppa. You can see the edge of town just to the north. Maybe if you talk with someone there, you can find information about Qud.

You can see Mehmet and three Watervines here.

>talk mehmet
That's not a verb I recognise.

>talk to Mehmet
That's not a verb I recognise.

* * *

Joppa
An Interactive Fiction by Alden Jones
Release 1 / Serial number 180926 / Inform 7 build 6M62 (I6/v6.33 lib 6/12N) SD

Outskirts
Finally you have reached Joppa. You can see the edge of town just to the north. Maybe if you talk with someone there, you can find information about Qud.

You can see Mehmet and three Watervines here.

>talk to Mehmet
you say "live and drink, friend", Mehmet responds "live and drink"

>look at mehmet
You see nothing special about Mehmet.

* * *

>talk to Mehmet
you say "live and drink, friend", Mehmet responds "live and drink"

>trade mehmet
That's not a verb I recognise.

>go north
Joppa
You can see Ctesiphus, Zealot, Irudad, a Warden, Tam and a chest (closed) here.

>touch Ctesiphus
You feel nothing unexpected.

>pet Ctesiphus
That's not a verb I recognise.

* * *

Joppa
An Interactive Fiction by Alden Jones
Release 1 / Serial number 180926 / Inform 7 build 6M62 (I6/v6.33 lib 6/12N) SD

Outskirts
Finally you have reached Joppa. You can see the edge of town just to the north. Maybe if you talk with someone there, you can find information about Qud.

You can see Mehmet and three Watervines here.

>tune key
*** Run-time problem P10: Since the key is not allowed the property "in tune", it is against the rules to try to use it.

* * *

Joppa
An Interactive Fiction by Alden Jones
Release 1 / Serial number 180926 / Inform 7 build 6M62 (I6/v6.33 lib 6/12N) SD

Outskirts
Finally you have reached Joppa. You can see the edge of town just to the north. Maybe if you talk with someone there, you can find information about Qud.

You can see Mehmet and three Watervines here.

>tune piano
you tune the grand piano

>play piano
You play a tune on the grand piano. It sounds lovely

* * *

Joppa
An Interactive Fiction by Alden Jones
Release 1 / Serial number 180926 / Inform 7 build 6M62 (I6/v6.33 lib 6/12N) SD

Outskirts
Finally you have reached Joppa. You can see the edge of town just to the north. Maybe if you talk with someone there, you can find information about Qud.

You can see Mehmet and three Watervines here.

>walk north
Bar
You can see a bartender here.

>order a drink
That's not a verb I recognise.

* * *

>walk north
Bar
You can see a bartender here.

>walk south
Studio
You can see a grand piano here.

>play piano
You play a tune on the grand piano. It sounds lovely

>play marimba
You can't see any such thing.

>play grand
You play a tune on the grand piano. It sounds lovely