The Day's Notes
An Interactive Fiction by Alden Jones
Release 1 / Serial number 180919 / Inform 7 build 6M62 (I6/v6.33 lib 6/12N) SD

Studio
You can see a grand piano and a key here.

>Walk
You'll have to say which compass direction to go in.

>walk
You'll have to say which compass direction to go in.

>walk up
You can't go that way.

>walk down
You can't go that way.

>walk south
You can't go that way.

>walk north
You can't go that way.

* * *

The Day's Notes
An Interactive Fiction by Alden Jones
Release 1 / Serial number 180919 / Inform 7 build 6M62 (I6/v6.33 lib 6/12N) SD

Studio
You can see a grand piano and a key here.

>dance
You dance

>dancing
That's not a verb I recognise.

>dance
That's not a verb I recognise.

* * *

The Day's Notes
An Interactive Fiction by Alden Jones
Release 1 / Serial number 180919 / Inform 7 build 6M62 (I6/v6.33 lib 6/12N) SD

Studio
You can see a grand piano and a key here.

>examine piano
You see nothing special about the grand piano.

>check piano
You see nothing special about the grand piano.

>tune piano
That's not a verb I recognise.

* * *

The Day's Notes
An Interactive Fiction by Alden Jones
Release 1 / Serial number 180919 / Inform 7 build 6M62 (I6/v6.33 lib 6/12N) SD

Studio
You can see a grand piano and a key here.

>go north
Bar
An old man wearing a faded tuxedo

You can see a french horn and a bartender here.

>go outside
Street

* * *

The Day's Notes
An Interactive Fiction by Alden Jones
Release 1 / Serial number 180919 / Inform 7 build 6M62 (I6/v6.33 lib 6/12N) SD

Studio
You can see a grand piano and a key here.

>look
Studio
You can see a grand piano and a key here.

>examine piano
You see nothing special about the grand piano.

>eat piano
That's plainly inedible.

>eat Studio
You can't see any such thing.

>eat everything
You can't use multiple objects with that verb.

* * *

>look
Studio
You can see a grand piano and a key here.

>go north
Bar
You can see a french horn and a bartender here.

>take bartender
Taken.

>go outside
Street
You can see a discarded newspaper here.

>read newspaper
You see nothing special about the discarded newspaper.

>drop bartender
Dropped.

>look
Street
You can see a bartender and a discarded newspaper here.

>talk bartender
That's not a verb I recognise.

>inventory
You are carrying nothing.

>eat newspaper
That's plainly inedible.

* * *

The Day's Notes
An Interactive Fiction by Alden Jones
Release 1 / Serial number 180919 / Inform 7 build 6M62 (I6/v6.33 lib 6/12N) SD

Studio
You can see a grand piano and a key here.

>play piano
You play a tune on the grand piano. It sounds awful

>examine piano
You see nothing special about the grand piano.

* * *

>play piano
You play a tune on the grand piano. It sounds awful

>tune piano
you tune the grand piano

>take key
Taken.

>take piano
Taken.

>inventory
You are carrying:
  a grand piano
  a key

* * *

The Day's Notes
An Interactive Fiction by Alden Jones
Release 1 / Serial number 180919 / Inform 7 build 6M62 (I6/v6.33 lib 6/12N) SD

Studio
You can see a grand piano and a key here.

>tune key
*** Run-time problem P10: Since the key is not allowed the property "in tune", it is against the rules to try to use it.

* * *

The Day's Notes
An Interactive Fiction by Alden Jones
Release 1 / Serial number 180919 / Inform 7 build 6M62 (I6/v6.33 lib 6/12N) SD

Studio
You can see a grand piano and a key here.

>tune piano
you tune the grand piano

>play piano
You play a tune on the grand piano. It sounds lovely

* * *

The Day's Notes
An Interactive Fiction by Alden Jones
Release 1 / Serial number 180919 / Inform 7 build 6M62 (I6/v6.33 lib 6/12N) SD

Studio
You can see a grand piano and a key here.

>walk north
Bar
You can see a bartender here.

>order a drink
That's not a verb I recognise.

* * *

>walk north
Bar
You can see a bartender here.

>walk south
Studio
You can see a grand piano here.

>play piano
You play a tune on the grand piano. It sounds lovely

>play marimba
You can't see any such thing.

>play grand
You play a tune on the grand piano. It sounds lovely